00 00 00 00 00 00 00 00 00 00 00 00 00 00 00 00 00 00 00 00 00 00 00 00 00 00 00 00 00 00 00 00 00 00 00 00 00 00 00 00 00 00 00 00 00 00 00 00 00 00 
00 00 00 00 00 00 00 00 00 00 00 00 00 00 00 00 00 00 00 00 00 00 00 00 00 00 00 00 00 00 00 00 00 00 00 00 00 00 00 00 00 00 00 00 00 00 00 00 00 00 
00 00 00 00 00 00 00 00 00 00 00 00 00 00 00 00 00 00 00 00 00 00 00 00 00 00 00 00 00 00 00 00 00 00 00 00 00 00 00 00 00 00 00 00 00 00 00 00 00 00 
00 00 00 00 00 00 00 00 00 00 00 00 00 00 00 00 00 00 00 00 00 00 00 00 00 00 00 00 00 00 00 00 00 00 00 00 00 00 00 00 00 00 00 00 00 00 00 00 00 00 
00 00 00 00 00 00 00 00 00 00 00 00 00 00 00 00 00 00 00 00 00 00 00 00 00 00 00 00 00 00 00 00 00 00 00 00 00 00 00 00 00 00 00 00 00 00 00 00 00 00 
00 00 00 00 00 15 13 13 13 13 13 13 13 16 25 26 35 33 33 33 36 25 26 45 43 43 43 43 43 43 43 43 46 25 26 35 33 33 33 36 25 26 45 43 46 00 00 00 00 00 
00 00 00 00 00 11 10 10 10 10 10 10 10 12 21 22 31 30 85 30 32 21 22 41 40 40 40 40 40 40 40 40 42 21 22 31 30 85 30 32 21 22 41 40 42 00 00 00 00 00 
00 00 00 00 00 11 10 10 10 10 10 10 10 12 21 22 31 30 85 30 32 21 22 41 40 40 40 40 40 40 40 40 42 21 22 31 30 85 30 32 21 22 41 40 42 00 00 00 00 00 
00 00 00 00 00 17 14 14 14 14 14 14 14 18 21 22 31 30 85 30 32 21 22 47 44 44 44 44 44 44 44 44 48 21 22 31 30 85 30 32 21 22 41 40 42 00 00 00 00 00 
00 00 00 00 00 65 63 63 63 63 63 63 63 66 21 22 31 30 85 30 32 21 22 51 50 50 50 50 50 50 50 50 52 21 22 31 30 85 30 32 21 22 47 44 48 00 00 00 00 00 
00 00 00 00 00 61 60 60 60 60 60 60 60 62 21 22 31 30 85 30 32 21 22 51 50 50 50 50 50 50 50 50 52 21 22 31 30 85 30 32 21 22 51 50 52 00 00 00 00 00 
00 00 00 00 00 61 60 60 91 60 60 60 60 62 21 22 31 30 85 30 32 21 22 51 50 50 50 50 50 50 50 50 52 21 22 31 30 85 30 32 21 22 51 50 52 00 00 00 00 00 
00 00 00 00 00 67 64 64 90 64 64 64 64 68 21 22 31 30 85 30 32 21 22 57 54 54 54 59 54 54 54 54 58 21 22 31 30 85 30 32 21 22 57 59 58 00 00 00 00 00 
00 00 00 00 00 23 23 23 23 23 23 23 23 23 80 22 31 30 85 30 32 21 81 23 23 23 23 23 23 23 23 23 23 80 22 31 30 85 30 32 21 81 23 23 26 00 00 00 00 00 
00 00 00 00 00 24 24 24 24 24 24 24 24 24 24 28 31 84 85 84 32 27 24 24 24 24 24 24 24 24 24 24 24 24 28 31 84 85 84 32 27 24 24 24 28 00 00 00 00 00 
00 00 00 00 00 35 33 33 33 33 33 33 33 33 33 33 30 30 30 30 30 33 33 33 33 33 33 33 33 33 33 33 33 33 33 30 30 30 30 30 33 33 33 33 36 00 00 00 00 00 
00 00 00 00 00 31 30 30 30 30 30 30 30 30 30 85 30 30 30 30 30 85 30 30 30 30 30 30 30 30 30 30 30 30 85 30 30 30 30 30 85 30 30 30 32 00 00 00 00 00 
00 00 00 00 00 31 84 84 84 84 84 84 84 84 84 84 30 30 86 30 30 84 84 84 84 84 84 84 84 84 84 84 84 84 84 30 30 86 30 30 84 84 84 84 32 00 00 00 00 00 
00 00 00 00 00 31 30 30 30 30 30 30 30 30 30 85 30 30 30 30 30 85 30 30 30 30 30 30 30 30 30 30 30 30 85 30 30 30 30 30 85 30 30 30 32 00 00 00 00 00 
00 00 00 00 00 37 34 34 34 34 34 34 34 34 34 34 30 30 30 30 30 34 34 34 34 34 34 34 34 34 34 34 34 34 34 30 30 30 30 30 34 34 34 34 38 00 00 00 00 00 
00 00 00 00 00 25 23 23 23 23 23 23 23 23 23 26 31 84 85 84 32 25 23 23 23 23 23 23 23 23 23 23 23 23 26 31 84 85 84 32 25 23 23 23 26 00 00 00 00 00 
00 00 00 00 00 20 20 20 20 20 20 20 20 20 20 22 31 30 85 30 32 21 92 92 92 92 92 92 92 92 92 92 92 92 22 31 30 85 30 32 21 83 24 24 28 00 00 00 00 00 
00 00 00 00 00 24 24 24 24 24 24 24 24 82 20 22 31 30 85 30 32 21 92 92 92 92 92 92 92 92 92 92 92 92 22 31 30 85 30 32 21 22 15 13 16 00 00 00 00 00 
00 00 00 00 00 35 33 33 33 33 33 33 36 21 20 22 31 30 85 30 32 21 92 92 92 92 92 92 92 92 92 92 92 92 22 31 30 85 30 32 21 22 11 10 12 00 00 00 00 00 
00 00 00 00 00 31 30 30 30 30 30 30 32 21 20 22 31 30 85 30 32 21 92 92 92 92 92 92 92 92 92 92 92 92 22 31 30 85 30 32 21 22 11 10 12 00 00 00 00 00 
00 00 00 00 00 31 30 30 30 30 30 30 32 21 20 22 31 30 85 30 32 21 92 92 92 92 92 92 92 92 92 92 92 92 22 31 30 85 30 32 21 22 17 14 18 00 00 00 00 00 
00 00 00 00 00 31 30 30 86 30 30 30 32 21 20 22 31 30 85 30 32 21 92 92 92 92 92 92 92 92 92 92 92 92 22 31 30 85 30 32 21 22 65 63 66 00 00 00 00 00 
00 00 00 00 00 31 30 30 30 30 30 30 32 21 20 22 31 30 85 30 32 21 92 92 92 92 92 92 92 92 92 92 92 92 22 31 30 85 30 32 21 22 61 60 62 00 00 00 00 00 
00 00 00 00 00 31 30 30 30 30 30 30 32 21 20 22 31 30 85 30 32 21 92 92 92 92 92 92 92 92 92 92 92 92 22 31 30 85 30 32 21 22 61 60 62 00 00 00 00 00 
00 00 00 00 00 31 30 30 30 30 30 30 32 21 20 22 31 30 85 30 32 21 92 92 92 92 92 92 92 92 92 92 92 92 22 31 30 85 30 32 21 22 45 43 46 00 00 00 00 00 
00 00 00 00 00 31 30 30 30 30 30 30 32 21 20 22 31 30 85 30 32 21 92 92 92 92 92 92 92 92 92 92 92 92 22 31 30 85 30 32 21 22 47 44 48 00 00 00 00 00 
00 00 00 00 00 31 30 30 30 30 30 30 32 21 20 22 31 30 85 30 32 21 92 92 92 92 92 92 92 92 92 92 92 92 22 31 30 85 30 32 21 22 51 50 52 00 00 00 00 00 
00 00 00 00 00 31 30 30 30 86 30 30 32 21 20 22 31 30 85 30 32 21 92 92 92 92 92 92 92 92 92 92 92 92 22 31 30 85 30 32 21 22 57 59 58 00 00 00 00 00 
00 00 00 00 00 23 23 23 30 30 23 23 23 80 20 22 31 30 85 30 32 21 92 92 92 92 92 92 92 92 92 92 92 92 22 31 30 85 30 32 21 81 23 23 23 00 00 00 00 00 
00 00 00 00 00 24 24 24 30 30 24 24 24 24 24 28 31 30 85 30 32 27 24 24 24 24 24 24 24 24 24 24 24 24 28 31 84 85 84 32 27 24 24 24 24 00 00 00 00 00 
00 00 00 00 00 35 33 33 30 30 33 33 33 33 33 33 30 30 30 30 30 33 33 33 33 33 33 33 33 33 33 33 33 33 33 30 30 30 30 30 33 33 33 33 36 00 00 00 00 00 
00 00 00 00 00 31 30 30 30 30 30 30 30 30 30 85 30 30 30 30 30 85 30 30 30 30 30 30 30 30 30 30 30 30 85 30 30 30 30 30 85 30 30 30 32 00 00 00 00 00 
00 00 00 00 00 31 84 84 84 84 84 84 84 84 84 84 30 30 86 30 30 84 84 84 84 84 84 84 84 84 84 84 84 84 84 30 30 86 30 30 84 84 84 84 32 00 00 00 00 00 
00 00 00 00 00 31 30 30 30 30 30 30 30 30 30 85 30 30 30 30 30 85 30 30 30 30 30 30 30 30 30 30 30 30 85 30 30 30 30 30 85 30 30 30 32 00 00 00 00 00 
00 00 00 00 00 37 34 34 34 34 34 34 34 34 34 34 30 30 30 30 30 34 34 34 34 34 34 34 34 34 34 34 34 34 34 30 30 30 30 30 34 34 34 34 38 00 00 00 00 00 
00 00 00 00 00 23 23 23 23 23 23 23 23 23 23 26 31 30 85 30 32 25 23 23 23 23 23 23 23 23 23 23 23 23 26 31 84 85 84 32 25 23 23 23 23 00 00 00 00 00 
00 00 00 00 00 15 13 13 13 13 13 13 13 16 82 22 31 30 85 30 32 21 20 20 20 20 20 20 20 20 20 20 20 20 22 31 30 85 30 32 27 24 15 13 13 00 00 00 00 00 
00 00 00 00 00 17 14 14 14 14 14 14 14 18 21 22 31 30 85 30 32 27 45 43 43 43 43 43 43 43 46 24 24 82 22 31 30 85 30 30 85 30 11 10 10 00 00 00 00 00 
00 00 00 00 00 61 60 60 60 60 60 60 60 62 21 22 31 30 85 30 30 36 47 44 44 44 44 44 44 44 48 86 30 21 22 31 30 85 30 30 85 84 17 14 14 00 00 00 00 00 
00 00 00 00 00 61 60 60 60 60 60 60 60 62 21 22 31 30 85 30 30 32 51 50 50 50 50 50 50 50 52 30 30 21 22 31 30 85 30 30 85 30 61 60 60 00 00 00 00 00 
00 00 00 00 00 00 00 00 00 00 00 00 00 00 00 00 00 00 00 00 00 00 00 00 00 00 00 00 00 00 00 00 00 00 00 00 00 00 00 00 00 00 00 00 00 00 00 00 00 00 
00 00 00 00 00 00 00 00 00 00 00 00 00 00 00 00 00 00 00 00 00 00 00 00 00 00 00 00 00 00 00 00 00 00 00 00 00 00 00 00 00 00 00 00 00 00 00 00 00 00 
00 00 00 00 00 00 00 00 00 00 00 00 00 00 00 00 00 00 00 00 00 00 00 00 00 00 00 00 00 00 00 00 00 00 00 00 00 00 00 00 00 00 00 00 00 00 00 00 00 00 
00 00 00 00 00 00 00 00 00 00 00 00 00 00 00 00 00 00 00 00 00 00 00 00 00 00 00 00 00 00 00 00 00 00 00 00 00 00 00 00 00 00 00 00 00 00 00 00 00 00 
00 00 00 00 00 00 00 00 00 00 00 00 00 00 00 00 00 00 00 00 00 00 00 00 00 00 00 00 00 00 00 00 00 00 00 00 00 00 00 00 00 00 00 00 00 00 00 00 00 00