03 03 03 03 03 03 03 03 03 03 03 03 03 03 03 03 03 03 03 03 03 03 03 03 03 03 03 03 03 03 03 03 03 03 03 03 03 03 03 03 03 03 03 03 03 03 03 03 03 03 03 03 03 03 03 03 03 03 03 03 03 03 03 03 03 03 03 03 03 03 03 03 03 03 03 03 03 03 03 03 03 03 03 03 03 03 03 03 03 03 03 03 03 03 03 03 03 03 03 06
01 00 00 00 00 00 00 00 00 00 00 00 00 00 00 00 00 00 00 00 00 00 00 00 00 00 00 00 00 00 00 00 00 00 00 00 00 00 00 00 00 00 00 00 00 00 00 00 00 00 00 00 00 00 00 00 00 00 00 00 00 00 00 00 00 00 00 00 00 00 00 00 00 00 00 00 00 00 00 00 00 00 00 00 00 00 00 00 00 00 00 00 00 00 00 00 00 00 00 02
01 00 00 00 00 00 00 00 00 00 00 00 00 00 00 00 00 00 00 00 00 00 00 00 00 00 00 00 00 00 00 00 00 00 00 00 00 00 00 00 00 00 00 00 00 00 00 00 00 00 00 00 00 00 00 00 00 00 00 00 00 00 00 00 00 00 00 00 00 00 00 00 00 00 00 00 00 00 00 00 00 00 00 00 00 00 00 00 00 00 00 00 00 00 00 00 00 00 00 02
01 00 00 00 00 00 00 00 00 00 00 00 00 00 00 00 00 00 00 00 00 00 00 00 00 00 00 00 00 00 00 00 00 00 00 00 00 00 00 00 00 00 00 00 00 00 00 00 00 00 00 00 00 00 00 00 00 00 00 00 00 00 00 00 00 00 00 00 00 00 00 00 00 00 00 00 00 00 00 00 00 00 00 00 00 00 00 00 00 00 00 00 00 00 00 00 00 00 00 02
01 00 00 00 00 00 00 00 00 00 00 00 00 00 00 00 00 00 00 00 00 00 00 00 00 00 00 00 00 00 00 00 00 00 00 00 00 00 00 00 00 00 00 00 00 00 00 00 00 00 00 00 00 00 00 00 00 00 00 00 00 00 00 00 00 00 00 00 00 00 00 00 00 00 00 00 00 00 00 00 00 00 00 00 00 00 00 00 00 00 00 00 00 00 00 00 00 00 00 02
01 00 00 00 00 00 00 00 00 00 00 00 00 00 00 00 00 00 00 00 00 00 00 00 00 00 00 00 00 00 00 00 00 00 00 00 00 00 00 00 00 00 00 00 00 00 00 00 00 00 00 00 00 00 00 00 00 00 00 00 00 00 00 00 00 00 00 00 00 00 00 00 00 00 00 00 00 00 00 00 00 00 00 00 00 00 00 00 00 00 00 00 00 00 00 00 00 00 00 02
01 00 00 00 00 00 00 00 00 00 00 00 00 00 00 00 00 00 00 00 00 00 00 00 00 00 00 00 00 00 00 00 00 00 00 00 00 00 00 00 00 00 00 00 00 00 00 00 00 00 00 00 00 00 00 00 00 00 00 00 00 00 00 00 00 00 00 00 00 00 00 00 00 00 00 00 00 00 00 00 00 00 00 00 00 00 00 00 00 00 00 00 00 00 00 00 00 00 00 02
01 00 00 00 00 00 00 00 00 00 00 00 00 00 00 00 00 00 00 00 00 00 00 00 00 00 00 00 00 00 00 00 00 00 00 00 00 00 00 00 00 00 00 00 00 00 00 00 00 00 00 00 00 00 00 00 00 00 00 00 00 00 00 00 00 00 00 00 00 00 00 00 00 00 00 00 00 00 00 00 00 00 00 00 00 00 00 00 00 00 00 00 00 00 00 00 00 00 00 02
01 00 00 00 00 00 00 00 00 00 00 00 00 00 00 00 00 00 00 00 00 00 00 00 00 00 00 00 00 00 00 00 00 00 00 00 00 00 00 00 00 00 00 00 00 00 00 00 00 00 00 00 00 00 00 00 00 00 00 00 00 00 00 00 00 00 00 00 00 00 00 00 00 00 00 00 00 00 00 00 00 00 00 00 00 00 00 00 00 00 00 00 00 00 00 00 00 00 00 02
01 00 00 00 00 00 00 00 00 00 00 00 00 00 00 00 00 00 00 00 00 00 00 00 00 00 00 00 00 00 00 00 00 00 00 00 00 00 00 00 00 00 00 00 00 00 00 00 00 00 00 00 00 00 00 00 00 00 00 00 00 00 00 00 00 00 00 00 00 00 00 00 00 00 00 00 00 00 00 00 00 00 00 00 00 00 00 00 00 00 00 00 00 00 00 00 00 00 00 02
01 00 00 00 00 00 00 00 00 00 00 00 00 00 00 00 00 00 00 00 00 00 00 00 00 00 00 00 00 00 00 00 00 00 00 00 00 00 00 00 00 00 00 00 00 00 00 00 00 00 00 00 00 00 00 00 00 00 00 00 00 00 00 00 00 00 00 00 00 00 00 00 00 00 00 00 00 00 00 00 00 00 00 00 00 00 00 00 00 00 00 00 00 00 00 00 00 00 00 02
01 00 00 00 00 00 00 00 00 00 00 00 00 00 00 00 00 00 00 00 00 00 00 00 00 00 00 00 00 00 00 00 00 00 00 00 00 00 00 00 00 00 00 00 00 00 00 00 00 00 00 00 00 00 00 00 00 00 00 00 00 00 00 00 00 00 00 00 00 00 00 00 00 00 00 00 00 00 00 00 00 00 00 00 00 00 00 00 00 00 00 00 00 00 00 00 00 00 00 02
01 00 00 00 00 00 00 00 00 00 00 00 00 00 00 00 00 00 00 00 00 00 00 00 00 00 00 00 00 00 00 00 00 00 00 00 00 00 00 00 00 00 00 00 00 00 00 00 00 00 00 00 00 00 00 00 00 00 00 00 00 00 00 00 00 00 00 00 00 00 00 00 00 00 00 00 00 00 00 00 00 00 00 00 00 00 00 00 00 00 00 00 00 00 00 00 00 00 00 02
01 00 00 00 00 00 00 00 00 00 00 00 00 00 00 00 00 00 00 00 00 00 00 00 00 00 00 00 00 00 00 00 00 00 00 00 00 00 00 00 00 00 00 00 00 00 00 00 00 00 00 00 00 00 00 00 00 00 00 00 00 00 00 00 00 00 00 00 00 00 00 00 00 00 00 00 00 00 00 00 00 00 00 00 00 00 00 00 00 00 00 00 00 00 00 00 00 00 00 02
01 00 00 00 00 00 00 00 00 00 00 00 00 00 00 00 00 00 00 00 00 00 00 00 00 00 00 00 00 00 00 00 00 00 00 00 00 00 00 00 00 00 00 00 00 00 00 00 00 00 00 00 00 00 00 00 00 00 00 00 00 00 00 00 00 00 00 00 00 00 00 00 00 00 00 00 00 00 00 00 00 00 00 00 00 00 00 00 00 00 00 00 00 00 00 00 00 00 00 02
01 00 00 00 00 00 00 00 00 00 00 00 00 00 00 00 00 00 00 00 00 00 00 00 00 00 00 00 00 00 00 00 00 00 00 00 00 00 00 00 00 00 00 00 00 00 00 00 00 00 00 00 00 00 00 00 00 00 00 00 00 00 00 00 00 00 00 00 00 00 00 00 00 00 00 00 00 00 00 00 00 00 00 00 00 00 00 00 00 00 00 00 00 00 00 00 00 00 00 02
01 00 00 00 00 00 00 00 00 00 00 00 00 00 00 00 00 00 00 00 00 00 00 00 00 00 00 00 00 00 00 00 00 00 00 00 00 00 00 00 00 00 00 00 00 00 00 00 00 00 00 00 00 00 00 00 00 00 00 00 00 00 00 00 00 00 00 00 00 00 00 00 00 00 00 00 00 00 00 00 00 00 00 00 00 00 00 00 00 00 00 00 00 00 00 00 00 00 00 02
01 00 00 00 00 00 00 00 00 00 00 00 00 00 00 00 00 00 00 00 00 00 00 00 00 00 00 00 00 00 00 00 00 00 00 00 00 00 00 00 00 00 00 00 00 00 00 00 00 00 00 00 00 00 00 00 00 00 00 00 00 00 00 00 00 00 00 00 00 00 00 00 00 00 00 00 00 00 00 00 00 00 00 00 00 00 00 00 00 00 00 00 00 00 00 00 00 00 00 02
01 00 00 00 00 00 00 00 00 00 00 00 00 00 00 00 00 00 00 00 00 00 00 00 00 00 00 00 00 00 00 00 00 00 00 00 00 00 00 00 00 00 00 00 00 00 00 00 00 00 00 00 00 00 00 00 00 00 00 00 00 00 00 00 00 00 00 00 00 00 00 00 00 00 00 00 00 00 00 00 00 00 00 00 00 00 00 00 00 00 00 00 00 00 00 00 00 00 00 02
01 00 00 00 00 00 00 00 00 00 00 00 00 00 00 00 00 00 00 00 00 00 00 00 00 00 00 00 00 00 00 00 00 00 00 00 00 00 00 00 00 00 00 00 00 00 00 00 00 00 00 00 00 00 00 00 00 00 00 00 00 00 00 00 00 00 00 00 00 00 00 00 00 00 00 00 00 00 00 00 00 00 00 00 00 00 00 00 00 00 00 00 00 00 00 00 00 00 00 02
01 00 00 00 00 00 00 00 00 00 00 00 00 00 00 00 00 00 00 00 00 00 00 00 00 00 00 00 00 00 00 00 00 00 00 00 00 00 00 00 00 00 00 00 00 00 00 00 00 00 00 00 00 00 00 00 00 00 00 00 00 00 00 00 00 00 00 00 00 00 00 00 00 00 00 00 00 00 00 00 00 00 00 00 00 00 00 00 00 00 00 00 00 00 00 00 00 00 00 02
01 00 00 00 00 00 00 00 00 00 00 00 00 00 00 00 00 00 00 00 00 00 00 00 00 00 00 00 00 00 00 00 00 00 00 00 00 00 00 00 00 00 00 00 00 00 00 00 00 00 00 00 00 00 00 00 00 00 00 00 00 00 00 00 00 00 00 00 00 00 00 00 00 00 00 00 00 00 00 00 00 00 00 00 00 00 00 00 00 00 00 00 00 00 00 00 00 00 00 02
01 00 00 00 00 00 00 00 00 00 00 00 00 00 00 00 00 00 00 00 00 00 00 00 00 00 00 00 00 00 00 00 00 00 00 00 00 00 00 00 00 00 00 00 00 00 00 00 00 00 00 00 00 00 00 00 00 00 00 00 00 00 00 00 00 00 00 00 00 00 00 00 00 00 00 00 00 00 00 00 00 00 00 00 00 00 00 00 00 00 00 00 00 00 00 00 00 00 00 02
01 00 00 00 00 00 00 00 00 00 00 00 00 00 00 00 00 00 00 00 00 00 00 00 00 00 00 00 00 00 00 00 00 00 00 00 00 00 00 00 00 00 00 00 00 00 00 00 00 00 00 00 00 00 00 00 00 00 00 00 00 00 00 00 00 00 00 00 00 00 00 00 00 00 00 00 00 00 00 00 00 00 00 00 00 00 00 00 00 00 00 00 00 00 00 00 00 00 00 02
01 00 00 00 00 00 00 00 00 00 00 00 00 00 00 00 00 00 00 04 04 04 04 04 04 04 04 04 04 04 04 04 04 04 04 04 04 04 04 04 04 04 04 04 04 04 04 04 04 04 04 04 04 04 04 04 04 04 04 04 04 04 04 04 04 04 04 04 04 04 04 04 04 04 04 04 04 04 04 04 04 04 00 00 00 00 00 00 00 00 00 00 00 00 00 00 00 00 00 02
01 00 00 00 00 00 00 00 00 00 00 00 00 00 00 00 00 00 02 15 13 13 13 13 13 13 13 13 13 16 23 35 33 33 36 23 15 13 13 13 13 13 13 16 23 45 43 43 43 43 43 43 43 43 43 46 23 35 33 33 36 23 45 43 43 46 23 15 13 13 13 13 13 13 13 16 23 13 13 13 13 13 01 00 00 00 00 00 00 00 00 00 00 00 00 00 00 00 00 02
01 00 00 00 00 00 00 00 00 00 00 00 00 00 00 00 00 00 02 11 10 10 10 10 10 10 10 10 10 12 20 31 30 30 32 20 11 10 10 10 10 10 10 12 20 41 40 40 40 40 40 40 40 40 40 42 20 31 30 30 32 20 47 44 44 48 20 11 10 10 10 10 10 10 10 12 20 11 10 10 10 12 01 00 00 00 00 00 00 00 00 00 00 00 00 00 00 00 00 02
01 00 00 00 00 00 00 00 00 00 00 00 00 00 00 00 00 00 02 11 10 10 10 10 10 10 10 10 10 12 20 31 30 30 32 20 11 10 10 10 10 10 10 12 20 47 44 44 44 44 44 44 44 44 44 48 20 31 30 30 32 20 55 53 53 56 20 11 10 10 10 10 10 10 10 12 20 14 14 14 14 14 01 00 00 00 00 00 00 00 00 00 00 00 00 00 00 00 00 02
01 00 00 00 00 00 00 00 00 00 00 00 00 00 00 00 00 00 02 17 14 14 14 14 14 14 14 14 14 18 20 31 30 30 32 20 11 10 10 10 10 10 10 12 20 55 53 53 53 53 53 53 53 53 53 56 20 31 30 30 32 20 51 50 50 52 20 17 14 14 14 14 14 14 14 18 20 65 63 63 63 66 01 00 00 00 00 00 00 00 00 00 00 00 00 00 00 00 00 02
01 00 00 00 00 00 00 00 00 00 00 00 00 00 00 00 00 00 02 65 63 63 63 63 63 63 63 63 63 66 20 31 30 30 32 20 17 14 14 14 14 14 14 14 20 51 50 50 50 50 50 50 50 50 50 52 20 31 30 30 32 20 51 50 50 52 20 65 63 63 63 63 63 63 63 66 20 61 60 60 60 62 01 00 00 00 00 00 00 00 00 00 00 00 00 00 00 00 00 02
01 00 00 00 00 00 00 00 00 00 00 00 00 00 00 00 00 00 02 61 60 60 60 60 60 60 60 60 60 62 20 31 30 30 32 20 65 63 63 63 63 63 63 66 20 51 50 50 50 50 50 50 50 50 50 52 20 31 30 30 32 20 51 50 50 52 20 61 60 60 60 60 60 60 60 62 20 61 60 60 60 62 01 00 00 00 00 00 00 00 00 00 00 00 00 00 00 00 00 02
01 00 00 00 00 00 00 00 00 00 00 00 00 00 00 00 00 00 02 61 60 60 60 60 60 60 60 60 60 62 20 31 30 30 32 20 61 60 60 60 60 60 60 62 20 51 50 50 50 50 50 50 50 50 50 52 20 31 30 30 32 20 51 50 50 52 20 61 60 60 60 60 60 60 60 62 20 61 60 60 60 62 01 00 00 00 00 00 00 00 00 00 00 00 00 00 00 00 00 02
01 00 00 00 00 00 00 00 00 00 00 00 00 00 00 00 00 00 02 67 64 64 64 64 64 64 64 64 64 68 20 31 30 30 32 20 67 64 64 64 64 64 64 68 20 57 54 54 54 54 54 54 54 54 54 58 20 31 30 30 32 20 57 54 54 58 20 67 64 64 64 64 64 64 64 68 20 67 64 64 64 68 01 00 00 00 00 00 00 00 00 00 00 00 00 00 00 00 00 02
01 00 00 00 00 00 00 00 00 00 00 00 00 00 00 00 00 00 02 23 23 23 23 23 23 23 23 23 23 23 22 31 30 30 32 21 23 23 23 23 23 23 23 23 20 23 23 23 23 23 23 23 23 23 23 23 22 31 30 30 32 21 23 23 23 23 20 23 23 23 23 23 23 23 23 23 20 23 23 23 23 23 01 00 00 00 00 00 00 00 00 00 00 00 00 00 00 00 00 02
01 00 00 00 00 00 00 00 00 00 00 00 00 00 00 00 00 00 02 24 24 24 24 24 24 24 24 24 24 24 24 31 30 30 32 24 24 24 24 24 24 24 24 24 24 24 24 24 24 24 24 24 24 24 24 24 24 31 30 30 32 24 24 24 24 24 24 24 24 24 24 24 24 24 24 24 24 24 24 24 24 24 01 00 00 00 00 00 00 00 00 00 00 00 00 00 00 00 00 02
01 00 00 00 00 00 00 00 00 00 00 00 00 00 00 00 00 00 02 35 33 33 33 33 33 33 33 33 33 33 33 30 30 30 30 33 33 33 33 33 33 33 33 33 33 33 33 33 33 33 33 33 33 33 33 33 33 30 30 30 30 33 33 33 33 33 33 33 33 33 33 33 33 33 33 33 33 33 33 33 33 33 01 00 00 00 00 00 00 00 00 00 00 00 00 00 00 00 00 02
01 00 00 00 00 00 00 00 00 00 00 00 00 00 00 00 00 00 02 31 30 30 30 30 30 30 30 30 30 30 30 30 30 30 30 30 30 30 30 30 30 30 30 30 30 30 30 30 30 30 30 30 30 30 30 30 30 30 30 30 30 30 30 30 30 30 30 30 30 30 30 30 30 30 30 30 30 30 30 30 30 32 01 00 00 00 00 00 00 00 00 00 00 00 00 00 00 00 00 02
01 00 00 00 00 00 00 00 00 00 00 00 00 00 00 00 00 00 02 31 30 30 30 30 30 30 30 30 30 30 30 30 30 30 30 30 30 30 30 30 30 30 30 30 30 30 30 30 30 30 30 30 30 30 30 30 30 30 30 30 30 30 30 30 30 30 30 30 30 30 30 30 30 30 30 30 30 30 30 30 30 32 01 00 00 00 00 00 00 00 00 00 00 00 00 00 00 00 00 02
01 00 00 00 00 00 00 00 00 00 00 00 00 00 00 00 00 00 02 31 30 30 30 30 30 30 30 30 30 30 30 30 30 30 30 30 30 30 30 30 30 30 30 30 30 30 30 30 30 30 30 30 30 30 30 30 30 30 30 30 30 30 30 30 30 30 30 30 30 30 30 30 30 30 30 30 30 30 30 30 30 32 01 00 00 00 00 00 00 00 00 00 00 00 00 00 00 00 00 02
01 00 00 00 00 00 00 00 00 00 00 00 00 00 00 00 00 00 02 37 34 34 34 34 34 34 34 34 34 34 34 30 30 30 30 34 34 34 34 34 34 34 34 34 34 34 34 34 34 34 34 34 34 34 34 34 34 34 34 34 34 34 34 34 34 34 34 34 34 34 34 34 34 30 30 30 30 34 34 34 34 34 01 00 00 00 00 00 00 00 00 00 00 00 00 00 00 00 00 02
01 00 00 00 00 00 00 00 00 00 00 00 00 00 00 00 00 00 02 25 23 23 23 23 23 23 23 23 23 23 23 31 30 30 32 23 23 23 23 23 23 23 23 23 23 23 23 23 23 23 23 23 23 23 23 23 23 23 23 23 23 23 23 23 23 23 23 23 23 23 23 23 23 31 30 30 32 23 23 23 23 23 01 00 00 00 00 00 00 00 00 00 00 00 00 00 00 00 00 02
01 00 00 00 00 00 00 00 00 00 00 00 00 00 00 00 00 00 02 27 24 24 24 24 24 24 24 24 24 24 22 31 30 30 32 21 24 24 24 24 24 24 24 24 24 24 24 24 24 24 24 24 24 24 24 24 24 24 24 24 24 24 24 24 24 24 24 24 24 24 24 24 22 31 30 30 32 21 24 24 24 24 01 00 00 00 00 00 00 00 00 00 00 00 00 00 00 00 00 02
01 00 00 00 00 00 00 00 00 00 00 00 00 00 00 00 00 00 02 45 43 43 43 43 43 43 43 43 43 46 20 31 30 30 32 20 13 13 13 13 13 71 70 70 70 73 73 73 73 73 73 73 73 73 73 73 73 73 73 73 73 73 73 73 73 73 73 73 73 73 73 73 20 31 30 30 32 20 15 13 13 16 01 00 00 00 00 00 00 00 00 00 00 00 00 00 00 00 00 02
01 00 00 00 00 00 00 00 00 00 00 00 00 00 00 00 00 00 02 41 40 40 40 40 40 40 40 40 40 42 20 31 30 30 32 20 14 14 14 14 14 43 43 43 43 71 70 70 70 70 70 70 70 70 70 70 70 70 70 70 70 70 70 70 70 70 70 70 70 70 70 72 20 31 30 30 32 20 11 10 10 12 01 00 00 00 00 00 00 00 00 00 00 00 00 00 00 00 00 02
01 00 00 00 00 00 00 00 00 00 00 00 00 00 00 00 00 00 02 41 40 40 40 40 40 40 40 40 40 42 20 31 30 30 32 20 63 63 63 63 63 44 44 44 44 71 70 70 70 70 70 70 70 70 70 70 70 70 70 70 70 70 70 70 74 74 74 74 74 74 70 72 20 31 30 30 32 20 11 10 10 12 01 00 00 00 00 00 00 00 00 00 00 00 00 00 00 00 00 02
01 00 00 00 00 00 00 00 00 00 00 00 00 00 00 00 00 00 02 41 40 40 40 40 40 40 40 40 40 42 20 31 30 30 32 20 64 64 64 64 64 53 53 53 53 71 70 70 70 70 70 70 70 70 70 70 70 70 70 70 70 70 70 72 43 43 43 43 43 43 71 72 20 31 30 30 32 20 11 10 10 12 01 00 00 00 00 00 00 00 00 00 00 00 00 00 00 00 00 02
01 00 00 00 00 00 00 00 00 00 00 00 00 00 00 00 00 00 02 47 44 44 44 44 44 44 44 44 44 48 20 31 30 30 32 20 73 73 73 73 73 54 54 54 54 71 70 70 70 70 70 70 70 70 70 70 70 70 70 74 74 74 74 74 41 40 40 40 40 42 71 72 20 31 30 30 32 20 17 14 14 18 01 00 00 00 00 00 00 00 00 00 00 00 00 00 00 00 00 02
01 00 00 00 00 00 00 00 00 00 00 00 00 00 00 00 00 00 02 55 53 53 53 53 53 53 53 53 53 56 20 31 30 30 32 20 71 70 70 70 70 73 73 73 73 70 70 70 70 70 70 70 70 70 70 70 70 70 72 13 13 13 13 13 44 44 44 44 44 44 71 72 20 31 30 30 32 20 65 63 63 66 01 00 00 00 00 00 00 00 00 00 00 00 00 00 00 00 00 02
01 00 00 00 00 00 00 00 00 00 00 00 00 00 00 00 00 00 02 51 50 50 50 50 50 50 50 50 50 52 20 31 30 30 32 20 71 70 70 70 70 70 70 70 70 70 70 70 70 70 70 70 70 70 70 70 70 70 72 14 14 14 14 14 51 50 50 50 53 53 71 72 20 31 30 30 32 20 67 64 64 68 01 00 00 00 00 00 00 00 00 00 00 00 00 00 00 00 00 02
01 00 00 00 00 00 00 00 00 00 00 00 00 00 00 00 00 00 02 57 54 54 54 54 54 54 54 54 54 58 20 31 30 30 32 20 71 70 70 70 70 70 70 70 70 70 70 70 70 70 70 70 70 70 70 70 70 70 72 63 63 63 63 63 13 13 13 13 51 52 71 72 20 31 30 30 32 21 23 23 23 23 01 00 00 00 00 00 00 00 00 00 00 00 00 00 00 00 00 02
01 00 00 00 00 00 00 00 00 00 00 00 00 00 00 00 00 00 02 25 23 23 23 23 23 23 23 23 23 23 22 31 30 30 32 20 71 70 70 70 70 70 70 70 70 70 70 70 70 70 70 70 70 70 70 70 70 70 72 61 60 60 60 62 14 14 14 14 51 52 71 72 20 31 30 30 32 21 24 24 24 24 01 00 00 00 00 00 00 00 00 00 00 00 00 00 00 00 00 02
01 00 00 00 00 00 00 00 00 00 00 00 00 00 00 00 00 00 02 27 24 24 24 24 24 24 24 24 24 24 22 31 30 30 32 20 71 70 70 70 70 70 70 70 70 70 70 70 70 70 70 70 70 70 70 70 70 70 72 61 60 60 60 60 63 63 63 63 54 54 71 72 20 31 30 30 32 20 45 43 43 46 01 00 00 00 00 00 00 00 00 00 00 00 00 00 00 00 00 02
01 00 00 00 00 00 00 00 00 00 00 00 00 00 00 00 00 00 02 15 13 13 13 13 13 13 13 13 13 16 20 31 30 30 32 20 71 70 70 70 70 70 70 70 70 70 70 70 70 70 70 70 70 70 70 70 70 70 72 64 64 64 64 64 64 64 64 64 73 73 70 72 20 31 30 30 32 20 41 40 40 42 01 00 00 00 00 00 00 00 00 00 00 00 00 00 00 00 00 02
01 00 00 00 00 00 00 00 00 00 00 00 00 00 00 00 00 00 02 11 10 10 10 10 10 10 10 10 10 12 20 31 30 30 32 20 74 74 74 74 70 70 70 70 70 70 70 70 70 70 70 70 70 70 70 70 70 70 70 73 73 73 73 73 73 73 73 73 70 70 70 72 20 31 30 30 32 20 41 40 40 42 01 00 00 00 00 00 00 00 00 00 00 00 00 00 00 00 00 02
01 00 00 00 00 00 00 00 00 00 00 00 00 00 00 00 00 00 02 11 10 10 10 10 10 10 10 10 10 12 20 31 30 30 32 20 43 43 43 43 74 74 74 74 74 74 74 70 70 70 70 70 70 70 70 70 70 70 70 70 70 70 70 70 70 70 70 70 70 70 70 72 20 31 30 30 32 20 41 40 40 42 01 00 00 00 00 00 00 00 00 00 00 00 00 00 00 00 00 02
01 00 00 00 00 00 00 00 00 00 00 00 00 00 00 00 00 00 02 17 14 14 14 14 14 14 14 14 14 18 20 31 30 30 32 20 44 44 44 44 11 10 13 13 13 13 13 71 70 70 70 70 70 70 70 70 70 70 70 70 70 70 70 70 70 70 70 70 70 70 70 72 20 31 30 30 32 20 47 44 44 48 01 00 00 00 00 00 00 00 00 00 00 00 00 00 00 00 00 02
01 00 00 00 00 00 00 00 00 00 00 00 00 00 00 00 00 00 02 65 63 63 63 63 63 63 63 63 63 66 20 31 30 30 32 20 53 53 53 53 43 43 14 14 14 14 14 71 70 70 70 70 70 70 70 70 70 70 70 70 70 70 70 70 70 70 70 70 70 70 70 72 20 31 30 30 32 20 55 53 53 56 01 00 00 00 00 00 00 00 00 00 00 00 00 00 00 00 00 02
01 00 00 00 00 00 00 00 00 00 00 00 00 00 00 00 00 00 02 61 60 60 60 60 60 60 60 60 60 62 20 31 30 30 32 20 51 50 50 52 44 44 63 63 63 63 63 71 70 70 70 70 70 70 70 70 70 70 70 70 70 70 70 70 70 70 70 70 70 70 70 72 20 31 30 30 32 20 51 50 50 52 01 00 00 00 00 00 00 00 00 00 00 00 00 00 00 00 00 02
01 00 00 00 00 00 00 00 00 00 00 00 00 00 00 00 00 00 02 61 60 60 60 60 60 60 60 60 60 62 20 31 30 30 32 20 51 50 50 50 53 53 61 60 60 60 62 71 70 70 70 70 70 70 70 70 70 70 70 70 70 70 70 70 70 70 70 70 70 70 70 72 20 31 30 30 32 20 51 50 50 52 01 00 00 00 00 00 00 00 00 00 00 00 00 00 00 00 00 02
01 00 00 00 00 00 00 00 00 00 00 00 00 00 00 00 00 00 02 67 64 64 64 64 64 64 64 64 64 68 20 31 30 30 32 20 54 54 54 54 54 54 64 64 64 64 64 74 74 74 74 74 74 74 74 74 74 74 74 74 74 74 74 74 74 74 74 74 74 74 74 74 20 31 30 30 32 20 57 54 54 58 01 00 00 00 00 00 00 00 00 00 00 00 00 00 00 00 00 02
01 00 00 00 00 00 00 00 00 00 00 00 00 00 00 00 00 00 02 25 23 23 23 23 23 23 23 23 23 23 22 31 30 30 32 21 23 23 23 23 23 23 23 23 23 23 23 23 23 23 23 23 23 23 23 23 23 23 23 23 23 23 23 23 23 23 23 23 23 23 23 23 22 31 30 30 32 21 23 23 23 26 01 00 00 00 00 00 00 00 00 00 00 00 00 00 00 00 00 02
01 00 00 00 00 00 00 00 00 00 00 00 00 00 00 00 00 00 02 27 24 24 24 24 24 24 24 24 24 24 24 31 30 30 32 24 24 24 24 24 24 24 24 24 24 24 24 24 24 24 24 24 24 24 24 24 24 24 24 24 24 24 24 24 24 24 24 24 24 24 24 24 24 31 30 30 32 24 24 24 24 28 01 00 00 00 00 00 00 00 00 00 00 00 00 00 00 00 00 02
01 00 00 00 00 00 00 00 00 00 00 00 00 00 00 00 00 00 02 35 33 33 33 33 33 33 33 33 33 33 33 30 30 30 30 33 33 33 33 33 33 33 33 33 33 33 33 33 33 33 33 33 33 33 33 33 33 33 33 33 33 33 33 33 33 33 33 33 33 33 33 33 33 30 30 30 30 33 33 33 33 33 01 00 00 00 00 00 00 00 00 00 00 00 00 00 00 00 00 02
01 00 00 00 00 00 00 00 00 00 00 00 00 00 00 00 00 00 02 31 30 30 30 30 30 30 30 30 30 30 30 30 30 30 30 30 30 30 30 30 30 30 30 30 30 30 30 30 30 30 30 30 30 30 30 30 30 30 30 30 30 30 30 30 30 30 30 30 30 30 30 30 30 30 30 30 30 30 30 30 30 32 01 00 00 00 00 00 00 00 00 00 00 00 00 00 00 00 00 02
01 00 00 00 00 00 00 00 00 00 00 00 00 00 00 00 00 00 02 31 30 30 30 30 30 30 30 30 30 30 30 30 30 30 30 30 30 30 30 30 30 30 30 30 30 30 30 30 30 30 30 30 30 30 30 30 30 30 30 30 30 30 30 30 30 30 30 30 30 30 30 30 30 30 30 30 30 30 30 30 30 32 01 00 00 00 00 00 00 00 00 00 00 00 00 00 00 00 00 02
01 00 00 00 00 00 00 00 00 00 00 00 00 00 00 00 00 00 02 31 30 30 30 30 30 30 30 30 30 30 30 30 30 30 30 30 30 30 30 30 30 30 30 30 30 30 30 30 30 30 30 30 30 30 30 30 30 30 30 30 30 30 30 30 30 30 30 30 30 30 30 30 30 30 30 30 30 30 30 30 30 32 01 00 00 00 00 00 00 00 00 00 00 00 00 00 00 00 00 02
01 00 00 00 00 00 00 00 00 00 00 00 00 00 00 00 00 00 02 37 34 34 34 34 34 34 34 34 34 34 34 34 34 34 34 34 34 34 34 34 34 34 34 34 34 34 34 34 34 34 34 34 34 34 34 34 34 34 34 34 34 34 34 34 34 34 34 34 34 34 34 34 34 30 30 30 30 34 34 34 34 34 01 00 00 00 00 00 00 00 00 00 00 00 00 00 00 00 00 02
01 00 00 00 00 00 00 00 00 00 00 00 00 00 00 00 00 00 02 25 23 23 23 23 23 23 23 23 23 23 23 23 23 23 23 23 23 23 23 23 23 23 23 23 23 23 23 23 23 23 23 23 23 23 23 23 23 23 23 23 23 23 23 23 23 23 23 23 23 23 23 23 23 31 30 30 32 23 23 23 23 26 01 00 00 00 00 00 00 00 00 00 00 00 00 00 00 00 00 02
01 00 00 00 00 00 00 00 00 00 00 00 00 00 00 00 00 00 02 27 24 24 24 20 20 24 24 24 24 24 24 24 24 24 24 24 20 24 24 24 24 24 24 24 24 24 24 24 24 20 20 24 24 24 24 24 24 24 24 24 24 20 20 24 24 24 24 24 24 24 24 24 22 31 30 30 32 21 24 24 24 28 01 00 00 00 00 00 00 00 00 00 00 00 00 00 00 00 00 02
01 00 00 00 00 00 00 00 00 00 00 00 00 00 00 00 00 00 02 15 13 13 16 21 22 45 43 43 43 43 43 43 43 43 43 46 20 15 13 13 16 45 43 43 46 15 13 13 16 21 22 45 43 43 43 43 43 43 43 43 46 21 22 15 13 13 13 13 13 13 13 13 20 31 30 30 32 20 15 13 13 16 01 00 00 00 00 00 00 00 00 00 00 00 00 00 00 00 00 02
01 00 00 00 00 00 00 00 00 00 00 00 00 00 00 00 00 00 02 11 10 10 12 21 22 41 40 40 40 40 40 40 40 40 40 42 20 11 10 10 12 41 40 40 42 11 10 10 12 21 22 41 40 40 40 40 40 40 40 40 42 21 22 11 10 10 10 10 10 10 10 16 20 31 30 30 32 20 11 10 10 12 01 00 00 00 00 00 00 00 00 00 00 00 00 00 00 00 00 02
01 00 00 00 00 00 00 00 00 00 00 00 00 00 00 00 00 00 02 17 14 14 18 21 22 41 40 40 40 40 40 40 40 40 40 42 20 11 10 10 12 41 40 40 42 11 10 10 12 21 22 41 40 40 40 40 40 40 40 40 42 21 22 11 10 10 10 10 10 10 10 12 20 31 30 30 32 20 11 10 10 12 01 00 00 00 00 00 00 00 00 00 00 00 00 00 00 00 00 02
01 00 00 00 00 00 00 00 00 00 00 00 00 00 00 00 00 00 02 61 60 60 62 21 22 41 40 40 40 40 40 40 40 40 40 42 20 11 10 10 12 41 40 40 42 11 10 10 12 21 22 47 44 44 44 44 44 44 44 44 48 21 22 11 10 10 10 10 10 10 10 12 20 31 30 30 32 20 11 10 10 12 01 00 00 00 00 00 00 00 00 00 00 00 00 00 00 00 00 02
01 00 00 00 00 00 00 00 00 00 00 00 00 00 00 00 00 00 02 45 43 43 46 21 22 41 40 40 40 40 40 40 40 40 40 42 20 11 10 10 12 41 40 40 42 11 10 10 12 21 22 51 50 50 50 50 50 50 50 50 52 21 22 11 10 10 10 10 10 10 10 12 20 31 30 30 32 20 17 14 14 18 01 00 00 00 00 00 00 00 00 00 00 00 00 00 00 00 00 02
01 00 00 00 00 00 00 00 00 00 00 00 00 00 00 00 00 00 02 41 40 40 42 21 22 46 44 44 44 44 44 44 44 44 44 48 20 17 14 14 18 47 44 44 48 17 14 14 18 21 22 15 13 13 13 13 13 13 13 13 16 21 22 17 14 14 14 14 14 14 14 18 20 31 30 30 32 20 65 63 63 66 01 00 00 00 00 00 00 00 00 00 00 00 00 00 00 00 00 02
01 00 00 00 00 00 00 00 00 00 00 00 00 00 00 00 00 00 02 47 44 44 48 24 24 55 53 53 53 53 53 53 53 53 53 56 24 65 63 63 66 55 53 53 56 65 63 63 66 24 24 17 14 14 14 14 14 14 14 14 18 24 24 61 60 60 60 60 60 60 60 62 24 34 34 34 34 24 67 64 64 68 01 00 00 00 00 00 00 00 00 00 00 00 00 00 00 00 00 02
01 00 00 00 00 00 00 00 00 00 00 00 00 00 00 00 00 00 00 03 03 03 03 03 03 03 03 03 03 03 03 03 03 03 03 03 03 03 03 03 03 03 03 03 03 03 03 03 03 03 03 03 03 03 03 03 03 03 03 03 03 03 03 03 03 03 03 03 03 03 03 03 03 03 03 03 03 03 03 03 03 03 00 00 00 00 00 00 00 00 00 00 00 00 00 00 00 00 00 02
01 00 00 00 00 00 00 00 00 00 00 00 00 00 00 00 00 00 00 00 00 00 00 00 00 00 00 00 00 00 00 00 00 00 00 00 00 00 00 00 00 00 00 00 00 00 00 00 00 00 00 00 00 00 00 00 00 00 00 00 00 00 00 00 00 00 00 00 00 00 00 00 00 00 00 00 00 00 00 00 00 00 00 00 00 00 00 00 00 00 00 00 00 00 00 00 00 00 00 02
01 00 00 00 00 00 00 00 00 00 00 00 00 00 00 00 00 00 00 00 00 00 00 00 00 00 00 00 00 00 00 00 00 00 00 00 00 00 00 00 00 00 00 00 00 00 00 00 00 00 00 00 00 00 00 00 00 00 00 00 00 00 00 00 00 00 00 00 00 00 00 00 00 00 00 00 00 00 00 00 00 00 00 00 00 00 00 00 00 00 00 00 00 00 00 00 00 00 00 02
01 00 00 00 00 00 00 00 00 00 00 00 00 00 00 00 00 00 00 00 00 00 00 00 00 00 00 00 00 00 00 00 00 00 00 00 00 00 00 00 00 00 00 00 00 00 00 00 00 00 00 00 00 00 00 00 00 00 00 00 00 00 00 00 00 00 00 00 00 00 00 00 00 00 00 00 00 00 00 00 00 00 00 00 00 00 00 00 00 00 00 00 00 00 00 00 00 00 00 02
01 00 00 00 00 00 00 00 00 00 00 00 00 00 00 00 00 00 00 00 00 00 00 00 00 00 00 00 00 00 00 00 00 00 00 00 00 00 00 00 00 00 00 00 00 00 00 00 00 00 00 00 00 00 00 00 00 00 00 00 00 00 00 00 00 00 00 00 00 00 00 00 00 00 00 00 00 00 00 00 00 00 00 00 00 00 00 00 00 00 00 00 00 00 00 00 00 00 00 02
01 00 00 00 00 00 00 00 00 00 00 00 00 00 00 00 00 00 00 00 00 00 00 00 00 00 00 00 00 00 00 00 00 00 00 00 00 00 00 00 00 00 00 00 00 00 00 00 00 00 00 00 00 00 00 00 00 00 00 00 00 00 00 00 00 00 00 00 00 00 00 00 00 00 00 00 00 00 00 00 00 00 00 00 00 00 00 00 00 00 00 00 00 00 00 00 00 00 00 02
01 00 00 00 00 00 00 00 00 00 00 00 00 00 00 00 00 00 00 00 00 00 00 00 00 00 00 00 00 00 00 00 00 00 00 00 00 00 00 00 00 00 00 00 00 00 00 00 00 00 00 00 00 00 00 00 00 00 00 00 00 00 00 00 00 00 00 00 00 00 00 00 00 00 00 00 00 00 00 00 00 00 00 00 00 00 00 00 00 00 00 00 00 00 00 00 00 00 00 02
01 00 00 00 00 00 00 00 00 00 00 00 00 00 00 00 00 00 00 00 00 00 00 00 00 00 00 00 00 00 00 00 00 00 00 00 00 00 00 00 00 00 00 00 00 00 00 00 00 00 00 00 00 00 00 00 00 00 00 00 00 00 00 00 00 00 00 00 00 00 00 00 00 00 00 00 00 00 00 00 00 00 00 00 00 00 00 00 00 00 00 00 00 00 00 00 00 00 00 02
01 00 00 00 00 00 00 00 00 00 00 00 00 00 00 00 00 00 00 00 00 00 00 00 00 00 00 00 00 00 00 00 00 00 00 00 00 00 00 00 00 00 00 00 00 00 00 00 00 00 00 00 00 00 00 00 00 00 00 00 00 00 00 00 00 00 00 00 00 00 00 00 00 00 00 00 00 00 00 00 00 00 00 00 00 00 00 00 00 00 00 00 00 00 00 00 00 00 00 02
01 00 00 00 00 00 00 00 00 00 00 00 00 00 00 00 00 00 00 00 00 00 00 00 00 00 00 00 00 00 00 00 00 00 00 00 00 00 00 00 00 00 00 00 00 00 00 00 00 00 00 00 00 00 00 00 00 00 00 00 00 00 00 00 00 00 00 00 00 00 00 00 00 00 00 00 00 00 00 00 00 00 00 00 00 00 00 00 00 00 00 00 00 00 00 00 00 00 00 02
01 00 00 00 00 00 00 00 00 00 00 00 00 00 00 00 00 00 00 00 00 00 00 00 00 00 00 00 00 00 00 00 00 00 00 00 00 00 00 00 00 00 00 00 00 00 00 00 00 00 00 00 00 00 00 00 00 00 00 00 00 00 00 00 00 00 00 00 00 00 00 00 00 00 00 00 00 00 00 00 00 00 00 00 00 00 00 00 00 00 00 00 00 00 00 00 00 00 00 02
01 00 00 00 00 00 00 00 00 00 00 00 00 00 00 00 00 00 00 00 00 00 00 00 00 00 00 00 00 00 00 00 00 00 00 00 00 00 00 00 00 00 00 00 00 00 00 00 00 00 00 00 00 00 00 00 00 00 00 00 00 00 00 00 00 00 00 00 00 00 00 00 00 00 00 00 00 00 00 00 00 00 00 00 00 00 00 00 00 00 00 00 00 00 00 00 00 00 00 02
01 00 00 00 00 00 00 00 00 00 00 00 00 00 00 00 00 00 00 00 00 00 00 00 00 00 00 00 00 00 00 00 00 00 00 00 00 00 00 00 00 00 00 00 00 00 00 00 00 00 00 00 00 00 00 00 00 00 00 00 00 00 00 00 00 00 00 00 00 00 00 00 00 00 00 00 00 00 00 00 00 00 00 00 00 00 00 00 00 00 00 00 00 00 00 00 00 00 00 02
01 00 00 00 00 00 00 00 00 00 00 00 00 00 00 00 00 00 00 00 00 00 00 00 00 00 00 00 00 00 00 00 00 00 00 00 00 00 00 00 00 00 00 00 00 00 00 00 00 00 00 00 00 00 00 00 00 00 00 00 00 00 00 00 00 00 00 00 00 00 00 00 00 00 00 00 00 00 00 00 00 00 00 00 00 00 00 00 00 00 00 00 00 00 00 00 00 00 00 02
01 00 00 00 00 00 00 00 00 00 00 00 00 00 00 00 00 00 00 00 00 00 00 00 00 00 00 00 00 00 00 00 00 00 00 00 00 00 00 00 00 00 00 00 00 00 00 00 00 00 00 00 00 00 00 00 00 00 00 00 00 00 00 00 00 00 00 00 00 00 00 00 00 00 00 00 00 00 00 00 00 00 00 00 00 00 00 00 00 00 00 00 00 00 00 00 00 00 00 02
01 00 00 00 00 00 00 00 00 00 00 00 00 00 00 00 00 00 00 00 00 00 00 00 00 00 00 00 00 00 00 00 00 00 00 00 00 00 00 00 00 00 00 00 00 00 00 00 00 00 00 00 00 00 00 00 00 00 00 00 00 00 00 00 00 00 00 00 00 00 00 00 00 00 00 00 00 00 00 00 00 00 00 00 00 00 00 00 00 00 00 00 00 00 00 00 00 00 00 02
01 00 00 00 00 00 00 00 00 00 00 00 00 00 00 00 00 00 00 00 00 00 00 00 00 00 00 00 00 00 00 00 00 00 00 00 00 00 00 00 00 00 00 00 00 00 00 00 00 00 00 00 00 00 00 00 00 00 00 00 00 00 00 00 00 00 00 00 00 00 00 00 00 00 00 00 00 00 00 00 00 00 00 00 00 00 00 00 00 00 00 00 00 00 00 00 00 00 00 02
01 00 00 00 00 00 00 00 00 00 00 00 00 00 00 00 00 00 00 00 00 00 00 00 00 00 00 00 00 00 00 00 00 00 00 00 00 00 00 00 00 00 00 00 00 00 00 00 00 00 00 00 00 00 00 00 00 00 00 00 00 00 00 00 00 00 00 00 00 00 00 00 00 00 00 00 00 00 00 00 00 00 00 00 00 00 00 00 00 00 00 00 00 00 00 00 00 00 00 02
01 00 00 00 00 00 00 00 00 00 00 00 00 00 00 00 00 00 00 00 00 00 00 00 00 00 00 00 00 00 00 00 00 00 00 00 00 00 00 00 00 00 00 00 00 00 00 00 00 00 00 00 00 00 00 00 00 00 00 00 00 00 00 00 00 00 00 00 00 00 00 00 00 00 00 00 00 00 00 00 00 00 00 00 00 00 00 00 00 00 00 00 00 00 00 00 00 00 00 02
01 00 00 00 00 00 00 00 00 00 00 00 00 00 00 00 00 00 00 00 00 00 00 00 00 00 00 00 00 00 00 00 00 00 00 00 00 00 00 00 00 00 00 00 00 00 00 00 00 00 00 00 00 00 00 00 00 00 00 00 00 00 00 00 00 00 00 00 00 00 00 00 00 00 00 00 00 00 00 00 00 00 00 00 00 00 00 00 00 00 00 00 00 00 00 00 00 00 00 02
01 00 00 00 00 00 00 00 00 00 00 00 00 00 00 00 00 00 00 00 00 00 00 00 00 00 00 00 00 00 00 00 00 00 00 00 00 00 00 00 00 00 00 00 00 00 00 00 00 00 00 00 00 00 00 00 00 00 00 00 00 00 00 00 00 00 00 00 00 00 00 00 00 00 00 00 00 00 00 00 00 00 00 00 00 00 00 00 00 00 00 00 00 00 00 00 00 00 00 02
01 00 00 00 00 00 00 00 00 00 00 00 00 00 00 00 00 00 00 00 00 00 00 00 00 00 00 00 00 00 00 00 00 00 00 00 00 00 00 00 00 00 00 00 00 00 00 00 00 00 00 00 00 00 00 00 00 00 00 00 00 00 00 00 00 00 00 00 00 00 00 00 00 00 00 00 00 00 00 00 00 00 00 00 00 00 00 00 00 00 00 00 00 00 00 00 00 00 00 02
01 00 00 00 00 00 00 00 00 00 00 00 00 00 00 00 00 00 00 00 00 00 00 00 00 00 00 00 00 00 00 00 00 00 00 00 00 00 00 00 00 00 00 00 00 00 00 00 00 00 00 00 00 00 00 00 00 00 00 00 00 00 00 00 00 00 00 00 00 00 00 00 00 00 00 00 00 00 00 00 00 00 00 00 00 00 00 00 00 00 00 00 00 00 00 00 00 00 00 02
04 04 04 04 04 04 04 04 04 04 04 04 04 04 04 04 04 04 04 04 04 04 04 04 04 04 04 04 04 04 04 04 04 04 04 04 04 04 04 04 04 04 04 04 04 04 04 04 04 04 04 04 04 04 04 04 04 04 04 04 04 04 04 04 04 04 04 04 04 04 04 04 04 04 04 04 04 04 04 04 04 04 04 04 04 04 04 04 04 04 04 04 04 04 04 04 04 04 04 08
